         1,         2,         3,         1
         2,         5,         3,         4
         3,         3,         6,         7
         4,         3,         8,         9
         5,         3,         5,         6
         6,         7,         1,         3
         7,         3,         2,         8
         8,         9,         4,         3